#info
scale=1.3
music=techno03
background=backdrop

#player
startx=4
starty=8
velocityx=100

#size
width=62
heigth=15

#tiles
11 11 11 11 11 11 11 11 11 11 11 11 11 11 11 11 11 11 11 11 11 11 11 21 -- -- -- -- -- -- -- -- -- -- 01 11 11 11 11 11 11 11 11 11 11 11 11 11 11 11 11 11 11 11 11 11 11 11 11 11 11 11
11 11 11 11 11 11 11 11 11 11 11 11 11 11 11 11 11 11 11 11 11 11 11 21 -- -- -- -- -- -- -- -- -- -- 01 11 11 11 11 11 11 11 11 11 11 11 11 11 11 11 11 11 11 11 11 11 11 11 11 11 11 11
11 11 11 11 11 11 11 11 11 11 11 11 11 11 11 11 11 11 11 11 11 11 11 21 -- -- -- -- -- -- -- -- -- -- 01 11 11 11 11 11 11 11 11 11 11 11 11 11 11 11 11 11 11 11 11 11 11 11 11 11 11 11
11 11 11 11 11 11 11 11 11 11 11 11 11 11 11 11 11 11 11 11 11 11 11 21 -- -- -- -- -- -- -- -- -- -- 01 11 11 11 11 11 11 11 11 11 11 11 11 11 11 11 11 11 11 11 11 11 11 11 11 11 11 11
12 12 12 12 12 12 12 12 12 12 12 12 12 12 12 12 12 12 12 12 12 12 12 22 -- -- -- -- -- -- -- -- -- -- 02 12 12 12 12 12 12 12 12 12 12 12 12 12 12 12 12 12 12 12 12 12 12 12 12 12 12 12
-- -- -- -- -- -- -- 42 -- -- -- -- -- 42 -- -- -- -- -- -- -- -- -- -- -- -- -- -- -- -- -- -- -- -- -- -- -- -- -- -- -- -- -- -- -- 99 -- -- -- -- -- -- -- -- -- 91 -- -- -- -- -- --
-- -- -- -- -- -- -- 42 -- -- -- -- -- 42 -- -- -- -- -- -- -- -- -- -- -- -- -- -- -- -- -- -- -- -- -- -- -- -- -- -- -- -- -- -- -- 99 -- -- -- -- -- -- -- -- -- 91 -- -- -- -- -- --
-- -- -- -- -- -- -- 42 -- -- -- -- -- 42 -- -- -- -- -- -- -- -- -- -- -- -- -- -- -- -- -- -- -- -- -- -- -- -- -- -- -- -- -- -- -- 99 -- -- -- -- -- -- -- -- -- 91 -- -- -- -- -- --
-- -- -- -- -- -- -- 42 -- -- -- -- -- 42 -- -- -- -- -- -- -- -- -- -- -- -- -- -- -- -- -- -- -- -- -- -- -- -- -- -- -- -- -- -- -- 99 -- -- -- -- -- -- -- -- -- 91 -- -- -- -- -- --
10 10 10 10 10 10 10 10 10 10 10 10 10 10 10 10 10 10 10 10 10 10 10 20 -- -- 32 32 32 32 -- -- -- -- -- -- -- -- -- -- 00 10 10 10 10 10 10 10 10 10 10 10 10 10 10 10 10 10 10 10 10 10
11 11 11 11 11 11 11 11 11 11 11 11 11 11 11 11 11 11 11 11 11 11 11 21 -- -- -- -- -- -- -- -- -- -- -- -- -- -- -- -- 01 11 11 11 11 11 11 11 11 11 11 11 11 11 11 11 11 11 11 11 11 11
11 11 11 11 11 11 11 11 11 11 11 11 11 11 11 11 11 11 11 11 11 11 11 21 -- -- -- -- -- -- -- -- -- -- -- -- -- -- -- -- 01 11 11 11 11 11 11 11 11 11 11 11 11 11 11 11 11 11 11 11 11 11
11 11 11 11 11 11 11 11 11 11 11 11 11 11 11 11 11 11 11 11 11 11 11 21 -- -- -- -- -- -- -- -- -- -- -- -- -- -- -- -- 01 11 11 11 11 11 11 11 11 11 11 11 11 11 11 11 11 11 11 11 11 11
11 11 11 11 11 11 11 11 11 11 11 11 11 11 11 11 11 11 11 11 11 11 11 21 -- -- -- -- -- -- -- -- -- -- -- -- -- -- -- -- 01 11 11 11 11 11 11 11 11 11 11 11 11 11 11 11 11 11 11 11 11 11
11 11 11 11 11 11 11 11 11 11 11 11 11 11 11 11 11 11 11 11 11 11 11 21 -- -- -- -- -- -- -- -- -- -- -- -- -- -- -- -- 01 11 11 11 11 11 11 11 11 11 11 11 11 11 11 11 11 11 11 11 11 11