#info
scale=1.3
music=techno03
background=backdrop_steel_looped

#player
startx=12
starty=20
velocityx=100

#size
width=91
heigth=22

#tiles
11 11 11 11 11 11 11 11 11 11 11 11 11 11 11 11 11 11 74 74 74 74 74 74 74 74 11 11 11 11 11 11 11 11 11 11 11 11 11 11 11 11 11 11 11 11 11 11 11 11 11 11 11 11 11 11 11 11 11 11 11 11 11 11 11 11 11 11 11 11 11 11 11 11 11 11 11 11 11 11 11 11 11 11 11 11 11 11 11 11 11
11 11 11 11 11 11 11 11 11 11 11 11 11 11 11 11 11 84 -- -- -- -- -- -- -- -- 64 11 11 11 11 11 11 11 11 11 11 11 11 11 11 11 11 11 11 11 11 11 11 11 11 11 11 11 11 11 11 11 11 11 11 11 11 11 11 11 11 11 11 11 11 11 11 11 11 11 11 11 11 11 11 11 11 11 11 11 11 11 11 11 11
11 12 12 11 12 12 12 12 12 12 12 66 74 74 74 74 84 -- -- -- -- -- -- -- -- -- -- 64 74 74 74 74 74 76 12 12 12 12 12 12 12 12 12 12 12 12 12 12 12 12 12 12 12 12 12 12 12 12 12 12 12 12 12 11 11 11 11 11 11 11 11 11 11 11 11 11 11 11 11 11 11 11 11 11 11 11 11 11 11 11 11
60 70 -- -- -- -- -- -- -- -- -- -- -- -- 42 -- -- -- -- -- -- -- -- -- -- -- -- -- -- -- -- -- -- -- -- 99 -- -- -- -- -- -- -- 80 -- -- -- -- -- -- -- -- -- -- -- -- -- -- -- -- -- -- -- 01 11 11 11 11 11 11 11 11 11 11 11 11 11 11 11 11 11 11 11 11 11 11 11 11 11 11 11
60 70 -- -- -- -- -- -- -- -- -- -- -- -- 42 -- -- -- -- -- -- -- -- -- -- -- -- -- -- -- -- -- -- -- -- 99 -- -- -- -- -- -- -- 80 -- -- -- -- -- -- -- -- -- -- -- -- -- -- -- -- -- -- -- 01 11 11 11 11 11 11 11 11 11 11 11 11 11 11 11 11 11 11 11 11 11 11 11 11 11 11 11
31 10 10 20 32 -- -- -- -- 00 10 13 13 13 10 10 10 10 20 -- -- -- -- -- -- 00 10 10 10 10 10 10 10 10 10 10 10 10 10 10 10 10 10 10 10 10 10 10 10 10 10 10 10 10 10 10 10 10 10 10 10 10 10 30 11 11 11 11 11 11 11 11 11 11 11 11 11 11 11 11 11 11 11 11 11 11 11 11 11 11 11
31 11 11 31 10 20 -- -- -- 01 11 11 11 11 11 11 11 11 31 72 72 72 72 72 72 30 11 11 11 11 11 11 11 11 11 31 11 11 11 11 11 11 11 11 11 11 11 11 11 11 11 11 11 11 11 11 11 11 11 11 11 11 11 11 11 11 11 11 11 11 11 11 11 11 11 11 11 11 11 11 11 11 11 11 11 11 11 11 11 11 11
11 11 11 11 11 21 -- -- -- 02 12 12 12 12 12 12 12 12 11 11 11 11 11 11 11 11 11 11 11 11 11 11 11 11 11 11 11 11 11 11 11 11 11 11 11 11 11 11 11 11 11 11 11 11 11 11 11 11 11 11 11 11 11 11 11 11 11 11 11 11 11 11 11 11 11 11 11 11 11 11 11 11 11 11 11 11 11 11 11 11 11
11 11 11 11 11 21 -- -- -- -- -- -- -- -- -- -- -- -- 01 11 11 11 11 11 11 11 11 11 11 11 11 11 11 11 11 11 11 11 11 11 11 11 11 11 11 11 11 11 11 11 11 11 11 11 11 11 11 11 11 11 11 11 11 11 11 11 11 11 11 11 11 11 11 11 11 11 11 11 11 11 11 11 11 11 11 11 11 11 11 11 11
11 11 11 11 11 21 -- -- -- -- -- -- -- 41 -- -- -- -- 01 11 74 74 74 74 74 11 11 11 11 11 11 11 11 11 11 11 11 11 11 11 11 11 11 11 11 11 11 11 11 11 11 11 11 11 11 11 11 11 11 11 11 11 11 11 11 11 11 11 11 11 11 11 11 11 11 11 11 11 11 11 11 11 11 11 11 11 11 11 11 11 11
11 11 11 11 11 31 10 55 55 10 20 -- -- 42 -- -- -- -- 64 84 -- -- -- -- -- 01 11 11 11 11 11 11 11 11 11 11 11 11 11 11 11 11 11 11 11 11 11 11 11 11 11 11 11 11 11 11 11 11 11 11 11 11 11 11 11 11 11 11 11 11 11 11 11 11 11 11 11 11 11 11 11 11 11 11 11 11 11 11 11 11 11
11 11 11 11 11 11 11 11 11 11 21 -- -- 42 -- -- -- -- -- -- -- -- -- -- -- 64 74 76 12 12 12 12 12 12 12 12 12 76 74 74 74 74 74 74 74 74 74 74 76 11 11 11 11 11 11 11 11 11 11 11 11 11 11 11 11 11 11 11 11 11 11 11 11 11 11 11 11 11 11 11 11 11 11 11 11 11 11 11 11 11 11
11 11 11 11 11 11 11 11 11 11 31 10 10 10 20 -- -- -- -- -- -- -- -- -- -- -- 42 -- -- -- -- -- -- -- -- -- 42 -- -- -- -- -- -- -- -- -- -- -- -- 01 11 11 11 11 11 11 11 11 11 11 11 11 11 11 11 11 11 11 11 11 11 11 11 11 11 11 11 11 11 11 11 11 11 11 11 11 11 11 11 11 11
11 11 11 11 11 11 11 11 11 11 11 11 11 11 21 -- -- -- -- -- -- -- -- -- -- -- 42 -- -- -- -- -- -- -- -- -- 42 -- -- -- -- -- -- -- -- -- -- -- -- 64 74 74 11 11 11 11 11 74 74 74 74 74 11 11 11 11 11 11 11 11 11 11 11 11 11 11 11 11 11 11 11 11 11 11 11 11 11 11 11 11 11
11 11 11 11 11 11 11 11 11 11 11 11 11 11 31 10 10 10 10 20 -- -- -- -- 00 10 43 43 10 10 65 72 72 72 75 10 10 13 13 13 10 10 10 20 -- -- -- -- -- -- -- -- 01 11 11 11 84 -- -- -- -- -- 64 11 11 11 11 11 11 11 11 11 11 11 11 11 11 11 11 11 11 11 11 11 11 11 11 11 11 11 11
11 11 11 11 11 11 11 11 11 11 11 11 11 12 12 12 12 12 12 22 -- -- -- -- 01 11 11 11 11 11 11 11 11 11 11 11 11 11 11 11 11 11 11 21 -- -- -- -- -- -- -- -- 64 74 74 84 -- -- -- -- -- -- -- 64 74 74 74 74 12 12 12 12 12 12 12 12 12 12 12 12 12 12 12 11 11 11 11 11 11 11 11
11 11 11 11 11 11 11 11 11 11 11 11 21 -- -- -- -- -- -- -- -- -- -- -- 01 11 11 11 11 11 11 11 11 11 11 11 11 11 11 11 11 11 11 31 10 10 20 -- -- -- -- -- -- -- -- -- -- -- -- -- -- -- -- -- -- -- 42 -- -- -- -- -- -- -- -- -- -- -- -- -- -- -- -- 02 11 11 11 11 11 11 11
11 11 11 11 11 11 11 11 11 11 12 12 22 -- -- -- -- -- -- -- -- -- -- -- 01 11 11 11 11 11 11 11 11 11 11 11 11 11 11 11 11 11 11 11 11 11 21 -- -- -- -- -- -- -- -- -- -- -- -- -- -- -- -- -- -- -- 42 -- -- -- -- -- -- -- -- -- -- -- -- -- 41 -- -- -- 02 12 12 12 12 12 11
11 11 11 11 11 11 11 11 11 21 -- 42 -- -- -- -- -- -- -- -- -- -- -- -- 01 11 11 11 11 11 11 11 11 11 11 11 11 11 11 11 11 11 11 11 11 11 31 10 10 20 -- 41 -- -- -- -- -- -- -- -- -- -- -- -- -- -- 42 -- -- -- -- -- -- -- -- -- -- -- -- -- 42 -- -- -- -- -- 42 -- -- 61 71
11 11 11 11 11 11 11 11 11 21 -- 42 -- -- -- -- -- -- 00 10 10 55 55 10 30 11 11 11 11 11 11 11 11 11 11 11 11 11 11 11 11 11 11 11 11 11 11 11 11 21 -- 42 -- -- -- -- -- -- -- -- -- -- -- -- -- -- 42 -- -- -- -- -- -- -- -- -- -- -- -- -- 42 -- -- -- -- -- 42 -- -- 61 71
11 11 11 11 11 11 11 11 11 21 -- 42 -- -- -- -- -- -- 01 11 11 11 11 11 11 11 11 11 11 11 11 11 11 11 11 11 11 11 11 11 11 11 11 11 11 11 11 11 11 11 10 10 13 13 13 10 20 -- -- -- -- -- 00 10 43 43 43 10 20 -- -- -- -- -- -- -- -- -- -- 00 10 20 -- -- -- -- 42 -- -- 61 71
11 11 11 11 11 11 11 11 11 11 10 10 10 10 10 10 10 10 30 11 11 11 11 11 11 11 11 11 11 11 11 11 11 11 11 11 11 11 11 11 11 11 11 11 11 11 11 11 11 11 11 11 11 11 11 11 21 -- -- -- -- -- 01 11 11 11 11 11 21 -- -- -- -- -- -- -- -- -- -- 01 11 31 10 10 10 10 10 10 10 10 30